+---------+    +----+
|   | |   |    | $  |
|         +----+    |
|  E   @            |
+--M----------------+
|           M       |
|          |$|$|$|  |
+----------+-+-+-+--+
