+---------+    +----+
|   | |   |    | $  |
|         +----+    |
|> E   @          (<|
+--M----------------+
|           M       |
|^v        |$|$|$|  |
+----------+-+-+-+--+
