/------------\
|$))))E     @|
|)))))E      |
+------      |
|            |
++++-E-++\   |
+++/OOO\++   |
++/OOOOO\+   |
++$$$$$$$|   |
\+-------+---/
